//MAP CONVERTED BY dmm2tgm.py THIS HEADER COMMENT PREVENTS RECONVERSION, DO NOT REMOVE
"a" = (
/obj/effect/turf_decal/bot{
	dir = 1
	},
/obj/structure/cable,
/obj/structure/table,
/obj/item/storage/box/lights/mixed,
/obj/item/stack/cable_coil,
/obj/item/stack/cable_coil,
/obj/item/stock_parts/power_store/cell/emproof,
/obj/item/stock_parts/power_store/cell/emproof{
	pixel_x = 6;
	pixel_y = -2
	},
/obj/effect/turf_decal/tile/neutral/fourcorners,
/obj/machinery/firealarm/directional/south{
	pixel_x = 4
	},
/obj/machinery/light_switch/directional/south{
	pixel_x = -5;
	pixel_y = -27
	},
/obj/machinery/button/door/directional/west{
	base_pixel_x = 4;
	base_pixel_y = 4;
	name = "Engineering Secure Storage Control";
	id = "engstorage";
	req_access = list("engine_equip")
	},
/turf/open/floor/iron/dark,
/area/station/engineering/engine_smes)

(1,1,1) = {"
a
"}
