//MAP CONVERTED BY dmm2tgm.py THIS HEADER COMMENT PREVENTS RECONVERSION, DO NOT REMOVE
"a" = (
/obj/effect/turf_decal/bot,
/obj/structure/rack,
/obj/item/clothing/suit/hazardvest,
/obj/item/clothing/suit/hazardvest,
/obj/item/tank/internals/emergency_oxygen/engi,
/obj/item/tank/internals/emergency_oxygen/engi,
/obj/item/clothing/glasses/meson,
/obj/item/clothing/glasses/meson,
/obj/structure/sign/warning/secure_area/directional/east,
/obj/machinery/button/door/directional/east{
	name = "Engineering Secure Storage Control";
	id = engstorage;
	req_access = list("engine_equip");
	pixel_y = 8
	},
/turf/open/floor/iron,
/area/station/engineering/main)

(1,1,1) = {"
a
"}
