//MAP CONVERTED BY dmm2tgm.py THIS HEADER COMMENT PREVENTS RECONVERSION, DO NOT REMOVE
"a" = (
/obj/effect/turf_decal/stripes/corner{
	dir = 1
	},
/obj/effect/turf_decal/trimline/yellow/filled/line{
	dir = 4
	},
/obj/machinery/power/apc/auto_name/directional/north{
	pixel_x = 6
	},
/obj/structure/cable,
/obj/machinery/button/door/directional/north{
	req_access = list("engine_equip");
	id = engstorage;
	name = "Engineering Secure Storage Control";
	pixel_y = 25;
	pixel_x = -10
	},
/turf/open/floor/iron,
/area/station/engineering/engine_smes)

(1,1,1) = {"
a
"}
