//MAP CONVERTED BY dmm2tgm.py THIS HEADER COMMENT PREVENTS RECONVERSION, DO NOT REMOVE
"a" = (
/turf/closed/indestructible/riveted/plastinum,
/area/shuttle/centcom/podbay_elevator)
"c" = (
/obj/machinery/light/small/directional/south,
/turf/open/floor/engine,
/area/shuttle/centcom/podbay_elevator)
"e" = (
/obj/machinery/light/small/directional/north,
/turf/open/floor/engine,
/area/shuttle/centcom/podbay_elevator)
"u" = (
/obj/machinery/computer/shuttle/centcom/podbay_elevator,
/turf/open/floor/engine,
/area/shuttle/centcom/podbay_elevator)
"H" = (
/obj/machinery/door/airlock/public/glass{
	name = "Elevator Access"
	},
/turf/open/floor/plating,
/area/shuttle/centcom/podbay_elevator)
"N" = (
/turf/open/floor/engine,
/area/shuttle/centcom/podbay_elevator)
"S" = (
/obj/machinery/door/airlock/public/glass{
	name = "Elevator Access"
	},
/obj/docking_port/mobile/elevator{
	dir = 4;
	shuttle_id = "centcom_supplypod";
	name = "centcom podbay elevator";
	dwidth = 3
	},
/turf/open/floor/plating,
/area/shuttle/centcom/podbay_elevator)

(1,1,1) = {"
a
a
H
S
H
a
a
"}
(2,1,1) = {"
a
u
N
N
N
c
a
"}
(3,1,1) = {"
a
N
N
N
N
N
a
"}
(4,1,1) = {"
a
N
N
N
N
N
a
"}
(5,1,1) = {"
a
N
N
N
N
N
a
"}
(6,1,1) = {"
a
e
N
N
N
N
a
"}
(7,1,1) = {"
a
a
a
a
a
a
a
"}
